18 16
#  ##########
#           #
#           #
########### #
          # #
          # #
          # #
          # #
          # #
          # #
      ##### ######
      #          #
      #          #
      #          #
      #          #
      ############
